15 30 373
0 352 176 8 16 2 4 2
0 768 176 8 16 2 10 2
0 240 744 8 16 2 3 9
0 96 1008 8 16 2 1 13
0 768 896 8 16 2 10 11
0 1432 192 8 16 2 19 2
0 1776 528 8 16 2 23 6
1 576 288 80 80 0 8 3
1 912 368 80 80 0 12 4
1 1328 448 80 80 0 18 5
1 1136 288 80 80 0 15 3
1 1696 432 80 80 0 23 5
1 1808 592 80 80 0 24 7
1 1184 880 80 80 0 16 11
1 944 528 80 80 1 13 6
1 1616 672 80 80 1 22 8
2 2190 378 64 64 1 29 4
2 1570 218 64 64 0 21 2
3 6 485 56 56 0 0 6
3 156 637 56 56 0 2 8
3 726 277 56 56 0 10 3
3 976 917 56 56 1 13 11
3 1360 93 56 56 1 18 0
3 1360 821 56 56 1 18 10
3 1174 981 56 56 1 15 12
3 1964 949 56 56 1 26 12
3 2086 90 56 56 1 28 0
3 2132 597 56 56 1 28 7
4 355 816 56 48 0 5 10
7 36 104 12 12 2 0 1
7 12 116 12 12 2 0 1
7 36 128 12 12 2 0 1
7 60 116 12 12 2 0 1
7 372 104 12 12 2 5 1
7 396 116 12 12 2 5 1
7 372 128 12 12 2 5 1
7 348 116 12 12 2 4 1
7 180 416 12 12 2 2 5
7 156 428 12 12 2 2 5
7 180 440 12 12 2 2 5
7 204 428 12 12 2 2 5
7 72 692 12 12 2 1 9
7 12 692 12 12 2 0 9
7 42 710 12 12 2 0 9
7 48 920 12 12 2 0 12
7 12 920 12 12 2 0 12
7 30 938 12 12 2 0 12
7 30 902 12 12 2 0 11
7 204 962 12 12 2 2 12
7 186 980 12 12 2 2 12
7 168 962 12 12 2 2 12
7 186 944 12 12 2 2 12
7 306 548 12 12 2 4 7
7 354 602 12 12 2 4 7
7 456 614 12 12 2 6 8
7 504 278 12 12 2 6 3
7 426 1028 12 12 2 5 13
7 474 1106 12 12 2 6 14
7 522 1106 12 12 2 7 14
7 444 1076 12 12 2 5 14
7 618 1070 12 12 2 8 14
7 618 980 12 12 2 8 12
7 672 1010 12 12 2 9 13
7 576 932 12 12 2 7 12
7 792 968 12 12 2 10 12
7 864 968 12 12 2 11 12
7 828 986 12 12 2 11 12
7 912 998 12 12 2 12 12
7 942 1016 12 12 2 12 13
7 978 980 12 12 2 13 12
7 762 662 12 12 2 10 8
7 798 692 12 12 2 10 9
7 1002 770 12 12 2 13 10
7 1032 758 12 12 2 13 9
7 968 758 12 12 2 13 0
7 728 308 12 12 2 9 3
7 764 326 12 12 2 10 4
7 798 308 12 12 2 10 3
7 876 278 12 12 2 11 3
7 1068 344 12 12 2 14 4
7 1050 404 12 12 2 14 4
7 1068 422 12 12 2 14 4
7 1086 404 12 12 2 14 4
7 840 470 12 12 2 11 6
7 810 482 12 12 2 10 6
7 774 470 12 12 2 10 6
7 1370 842 12 12 2 18 11
7 1400 824 12 12 2 18 10
7 1340 824 12 12 2 17 10
7 1464 1004 12 12 2 19 13
7 1494 986 12 12 2 19 12
7 1434 986 12 12 2 19 12
7 1662 1094 12 12 2 22 14
7 1722 1094 12 12 2 22 14
7 1740 1034 12 12 2 23 13
7 1740 986 12 12 2 23 12
7 1740 884 12 12 2 23 11
7 1740 788 12 12 2 23 10
7 1746 644 12 12 2 23 8
7 1710 644 12 12 2 22 8
7 1728 662 12 12 2 23 8
7 1578 566 12 12 2 21 7
7 1596 452 12 12 2 21 5
7 1614 470 12 12 2 21 6
7 1578 470 12 12 2 21 6
7 1596 488 12 12 2 21 6
7 1596 68 12 12 2 21 0
7 1614 86 12 12 2 21 1
7 1578 86 12 12 2 21 1
7 1596 104 12 12 2 21 1
7 1788 104 12 12 2 23 1
7 1944 356 12 12 2 25 4
7 1944 308 12 12 2 25 3
7 2124 968 12 12 2 28 12
7 2202 632 12 12 2 29 8
7 2232 614 12 12 2 29 8
7 2172 614 12 12 2 28 8
7 2229 372 12 12 2 29 4
7 2247 356 12 12 2 29 4
7 2229 340 12 12 2 29 4
7 2211 356 12 12 2 29 4
7 2232 86 12 12 2 29 1
7 2214 104 12 12 2 29 1
7 2196 86 12 12 2 29 1
7 1326 248 12 12 2 17 3
7 1164 500 12 12 2 15 6
7 1368 644 12 12 2 18 8
7 1302 692 12 12 2 17 9
8 792 840 16 16 2 10 10
8 1592 328 16 16 2 21 4
9 872 872 16 16 2 11 11
9 1336 920 16 16 2 17 12
9 1592 864 16 16 2 21 11
9 1640 920 16 16 2 21 12
9 1688 1128 16 16 2 22 14
9 1736 1064 16 16 2 23 13
9 2096 744 16 16 2 27 9
9 2116 724 16 16 2 28 9
9 2116 764 16 16 2 28 9
9 2136 744 16 16 2 28 9
10 0 832 48 56 2 0 10
10 256 328 48 56 2 3 3
10 1136 880 48 56 2 15 11
10 1144 408 48 56 2 15 5
10 1552 1112 48 56 2 20 14
11 464 352 24 32 2 6 4
11 720 800 24 32 2 9 10
11 1896 800 24 32 2 25 10
11 1656 800 24 32 2 22 10
12 349 357 36 24 0 4 4
12 349 453 36 24 0 4 5
12 300 405 36 24 1 4 5
12 285 501 36 24 1 4 6
12 557 882 36 24 0 7 11
12 605 1013 36 24 1 8 13
12 543 1045 36 24 0 7 13
12 605 933 36 24 1 8 12
12 653 965 36 24 0 8 12
12 653 293 36 24 0 8 3
12 1358 598 36 24 1 18 7
12 1295 642 36 24 0 17 8
12 1293 486 36 24 0 17 6
12 1214 277 36 24 1 16 3
12 1309 197 36 24 1 17 2
12 1245 165 36 24 0 16 1
12 1292 117 36 24 1 17 1
12 1440 821 36 24 0 19 10
12 1581 821 36 24 0 21 10
12 1629 869 36 24 1 21 11
12 1581 917 36 24 0 21 11
12 1629 965 36 24 1 21 12
12 1581 1013 36 24 0 21 13
12 1645 1045 36 24 1 22 13
12 1821 836 36 24 0 24 10
12 1965 772 36 24 0 26 9
12 1949 644 36 24 1 26 8
12 1981 596 36 24 0 26 7
12 2045 420 36 24 1 27 5
12 1981 372 36 24 0 26 4
12 2045 324 36 24 1 27 4
12 2109 276 36 24 0 28 3
12 2109 196 36 24 0 28 2
12 2061 244 36 24 1 27 3
12 2045 164 36 24 1 27 1
12 1981 116 36 24 0 26 1
12 1661 212 36 24 0 22 2
12 1629 260 36 24 1 21 3
13 542 670 80 104 0 7 8
13 654 670 80 104 1 9 8
13 654 558 80 104 0 9 6
13 542 558 80 104 1 7 6
13 943 158 80 104 0 13 1
13 1007 158 80 104 1 13 1
13 1071 158 80 104 2 14 1
14 1686 243 80 104 0 22 2
14 1686 275 80 104 0 22 2
14 1686 307 80 104 0 22 3
14 1686 339 80 104 0 22 3
14 1686 371 80 104 0 22 4
14 695 146 80 104 0 9 1
14 695 114 80 104 0 9 0
14 742 146 80 104 1 10 1
14 742 114 80 104 1 10 0
14 88 531 80 104 0 1 6
14 983 515 80 104 0 13 6
14 1030 515 80 104 0 14 6
14 1303 611 80 104 0 17 7
14 1303 580 80 104 0 17 6
14 1478 932 80 104 0 20 11
14 1942 882 80 104 0 26 10
15 2192 1072 80 208 2 29 12
16 0 40 2272 24 15 0 0
16 128 384 128 8 2 0 0
16 0 432 144 8 2 0 0
16 240 272 120 16 2 0 0
16 336 240 144 16 2 0 0
16 448 224 488 8 2 0 0
16 424 320 192 8 2 0 0
16 448 432 336 8 2 0 0
16 128 584 144 8 2 0 0
16 0 640 104 8 2 0 0
16 0 848 104 8 2 0 0
16 128 904 144 8 2 0 0
16 144 784 120 8 2 0 0
16 256 864 136 16 2 0 0
16 360 912 112 16 2 0 0
16 440 848 120 8 2 0 0
16 592 824 56 8 2 0 0
16 704 768 88 8 2 0 0
16 768 920 144 8 2 0 0
16 312 768 136 16 2 0 0
16 424 680 216 8 2 0 0
16 616 720 112 16 2 0 0
16 768 800 144 8 2 0 0
16 848 824 104 8 2 0 0
16 928 864 192 16 2 0 0
16 544 552 368 8 2 0 0
16 760 400 128 8 2 0 0
16 864 432 96 8 2 0 0
16 944 464 64 8 2 0 0
16 904 304 216 16 2 0 0
16 1048 368 72 16 2 0 0
16 872 624 104 16 2 0 0
16 944 688 168 16 2 0 0
16 1096 928 168 8 2 0 0
16 1120 816 144 8 2 0 0
16 1304 880 112 16 2 0 0
16 1384 928 176 16 2 0 0
16 1232 768 496 8 2 0 0
16 1064 656 168 8 2 0 0
16 1392 528 96 16 2 0 0
16 1112 448 168 8 2 0 0
16 1240 384 160 16 2 0 0
16 1320 320 104 16 2 0 0
16 1424 272 64 16 2 0 0
16 1408 208 80 16 2 0 0
16 1112 224 120 8 2 0 0
16 1568 160 256 16 2 0 0
16 1632 368 192 16 2 0 0
16 1616 608 184 16 2 0 0
16 1768 528 184 8 2 0 0
16 1504 848 48 8 2 0 0
16 1696 1024 48 8 2 0 0
16 1784 112 184 8 2 0 0
16 1832 288 104 8 2 0 0
16 1792 768 160 8 2 0 0
16 1872 896 264 16 2 0 0
16 2080 928 192 8 2 0 0
16 2032 688 240 16 2 0 0
16 2088 544 184 8 2 0 0
16 2144 432 128 16 2 0 0
16 2176 320 96 16 2 0 0
16 1568 528 64 16 2 0 0
16 1568 416 112 16 2 0 0
17 856 816 48 16 2 0 0
17 128 424 16 40 2 0 0
17 368 896 16 32 2 0 0
17 1088 672 16 16 2 0 0
17 336 256 16 16 2 0 0
17 240 576 16 192 2 0 0
17 240 376 16 104 2 0 0
17 240 896 16 112 2 0 0
17 448 840 16 160 2 0 0
17 448 896 16 48 2 0 0
17 432 672 16 248 2 0 0
17 480 312 16 88 2 0 0
17 768 1104 16 184 2 0 0
17 624 704 16 24 2 0 0
17 704 760 16 40 2 0 0
17 768 792 16 24 2 0 0
17 896 608 16 56 2 0 0
17 864 424 16 24 2 0 0
17 768 424 16 24 2 0 0
17 912 288 16 64 2 0 0
17 928 848 16 24 2 0 0
17 1120 920 16 104 2 0 0
17 960 672 16 48 2 0 0
17 944 456 16 24 2 0 0
17 1120 648 16 424 2 0 0
17 1248 440 16 56 2 0 0
17 1328 368 16 48 2 0 0
17 1248 808 16 40 2 0 0
17 1392 912 16 32 2 0 0
17 1520 840 16 72 2 0 0
17 1536 1136 16 208 2 0 0
17 1712 1016 16 248 2 0 0
17 1776 1136 16 528 2 0 0
17 1776 592 16 64 2 0 0
17 1488 736 80 736 2 0 0
17 1920 520 16 232 2 0 0
17 1648 400 16 32 2 0 0
18 84 632 8 168 2 0 0
18 84 424 8 184 2 0 0
18 132 376 8 216 2 0 0
18 276 848 8 304 2 0 0
18 1796 352 8 136 2 0 0
18 1044 672 8 168 2 0 0
18 2068 880 8 136 2 0 0
18 2052 672 8 232 2 0 0
18 1924 760 8 184 2 0 0
18 84 840 8 160 2 0 0
18 308 256 8 120 2 0 0
18 468 672 8 208 2 0 0
18 1652 592 8 144 2 0 0
20 176 368 40 344 2 2 2
21 496 184 32 160 2 6 1
22 816 768 32 744 2 11 5
23 1168 216 32 192 2 15 1
19 0 256 512 256 2 0 0
19 0 512 512 256 2 0 0
19 0 768 512 256 2 0 0
19 0 1024 512 256 2 0 0
19 0 1280 512 256 2 0 0
19 512 256 512 256 2 0 0
19 512 512 512 256 2 0 0
19 512 768 512 256 2 0 0
19 512 1024 512 256 2 0 0
19 512 1280 512 256 2 0 0
19 1024 256 512 256 2 0 0
19 1024 512 512 256 2 0 0
19 1024 768 512 256 2 0 0
19 1024 1024 512 256 2 0 0
19 1024 1280 512 256 2 0 0
19 1536 256 512 256 2 0 0
19 1536 512 512 256 2 0 0
19 1536 768 512 256 2 0 0
19 1536 1024 512 256 2 0 0
19 1536 1280 512 256 2 0 0
19 2048 256 512 256 2 0 0
19 2048 512 512 256 2 0 0
19 2048 768 512 256 2 0 0
19 2048 1024 512 256 2 0 0
19 2048 1280 512 256 2 0 0
19 2560 256 512 256 2 0 0
19 2560 512 512 256 2 0 0
19 2560 768 512 256 2 0 0
19 2560 1024 512 256 2 0 0
19 2560 1280 512 256 2 0 0
19 3072 256 512 256 2 0 0
19 3072 512 512 256 2 0 0
19 3072 768 512 256 2 0 0
19 3072 1024 512 256 2 0 0
19 3072 1280 512 256 2 0 0
19 3584 256 512 256 2 0 0
19 3584 512 512 256 2 0 0
19 3584 768 512 256 2 0 0
19 3584 1024 512 256 2 0 0
19 3584 1280 512 256 2 0 0
19 4096 256 512 256 2 0 0
19 4096 512 512 256 2 0 0
19 4096 768 512 256 2 0 0
19 4096 1024 512 256 2 0 0
19 4096 1280 512 256 2 0 0