7 64
0 0 0 0 0 0 0 0 0 0 0 0 0 0 0 0 0 0 0 0 0 0 0 0 0 0 0 0 0 0 0 0 0 0 0 0 0 0 0 0 0 0 0 0 0 0 0 0 0 0 0 0 0 0 0 0 0 0 0 0 0 0 0 0
1 2 3 2 4 5 3 3 3 3 3 3 3 3 3 3 3 3 3 3 3 3 2 4 5 3 3 3 3 3 2 3 3 2 3 3 3 3 3 3 3 3 3 3 3 3 3 3 3 3 3 3 3 3 3 3 3 3 3 3 3 3 3 3
6 7 8 9 10 11 12 12 13 14 15 16 17 16 18 19 12 12 18 19 12 12 7 10 11 18 19 12 18 19 7 8 20 9 8 21 12 18 19 12 12 18 19 12 12 12 22 23 12 12 24 17 16 25 24 26 14 16 12 27 12 12 18 19
28 29 30 31 31 32 27 33 34 35 36 37 35 37 38 12 12 39 17 16 40 12 29 31 32 12 22 41 41 23 29 30 30 31 30 32 27 12 42 12 22 41 23 27 12 42 43 44 18 45 34 35 37 46 47 36 35 37 38 18 48 17 40 16
49 50 51 52 52 53 50 54 55 55 55 56 55 56 55 57 53 58 59 60 61 62 50 52 53 42 43 63 63 44 50 51 51 52 51 53 50 53 64 65 43 63 44 65 42 64 43 44 50 54 55 55 56 55 56 55 55 56 55 53 58 59 61 60
66 67 67 67 67 67 67 67 67 67 67 67 67 67 67 67 68 69 70 69 70 69 70 69 70 64 43 63 63 44 69 69 71 72 69 73 67 67 74 67 75 76 77 68 64 64 43 44 69 69 78 69 78 69 78 69 73 67 67 67 67 67 67 67
79 80 80 80 80 80 80 80 80 80 80 80 80 80 80 80 81 69 82 69 82 69 82 69 82 82 83 84 84 85 69 69 83 82 69 86 80 80 80 80 80 80 80 81 82 82 83 85 69 69 87 69 87 69 87 69 86 80 80 80 80 80 80 80
