26 14
0 1 2 3 4 5 6 7 8 9 10 11 12 13 14 15 16 17 18 19 20 21 22 23 24 25
26 27 28 29 30 31 32 33 34 35 36 37 38 39 40 41 42 43 44 45 46 47 48 49 50 51
26 52 53 54 55 56 57 58 59 60 61 62 63 63 64 65 66 67 68 69 70 71 72 73 74 75
26 76 77 78 79 80 81 82 83 84 85 63 86 87 63 88 89 90 91 92 93 94 95 96 97 98
26 99 100 101 102 103 63 63 104 105 63 106 107 108 109 63 110 111 63 63 112 113 114 115 116 117
26 118 119 120 121 63 63 63 63 63 63 122 123 124 125 63 63 63 63 63 63 126 127 128 129 130
26 131 132 133 134 63 63 63 63 63 135 136 137 138 139 140 63 63 63 63 63 141 142 143 144 145
26 146 147 148 63 63 63 63 63 63 149 150 63 63 151 152 63 63 63 63 63 63 153 154 155 145
26 146 156 157 63 63 63 63 63 158 159 63 63 63 63 160 161 63 63 63 63 63 162 163 155 145
26 164 165 166 167 63 63 63 168 169 170 171 63 63 172 173 174 175 63 63 63 176 177 178 179 145
26 180 181 182 183 184 185 186 187 188 189 190 191 192 193 194 195 196 197 198 199 200 201 202 203 145
26 204 205 206 207 208 209 210 211 212 213 214 215 216 217 218 219 220 221 222 223 224 225 226 227 145
26 228 229 230 231 232 233 234 235 236 237 238 239 240 241 242 243 244 245 246 247 248 249 250 251 145
26 252 253 254 255 256 257 258 259 260 261 262 263 264 265 266 267 268 269 270 271 272 273 274 275 145
